0	0	0	0	0	0	0	0	0	0	0	0	0	0	0	0	0	0	0	0	0	0	0	0	0	0	0	0
0	0	0	0	0	0	0	0	0	0	0	0	0	0	0	0	0	0	0	0	0	0	0	0	0	0	0	0
0	0	0	0	0	0	0	0	0	0	0	0	0	0	0	0	0	0	0	0	0	0	0	0	0	0	0	0
1	1	1	1	1	1	1	1	1	1	1	1	1	1	1	1	1	1	1	1	1	1	1	1	1	1	1	1
1	2	2	2	2	2	2	2	2	2	2	2	2	1	1	2	2	2	2	2	2	2	2	2	2	2	2	1
1	2	1	1	1	1	2	1	1	1	1	1	2	1	1	2	1	1	1	1	1	2	1	1	1	1	2	1
1	4	1	1	1	1	2	1	1	1	1	1	2	1	1	2	1	1	1	1	1	2	1	1	1	1	4	1
1	2	1	1	1	1	2	1	1	1	1	1	2	1	1	2	1	1	1	1	1	2	1	1	1	1	2	1
1	2	2	2	2	2	2	2	2	2	2	2	2	2	2	2	2	2	2	2	2	2	2	2	2	2	2	1
1	2	1	1	1	1	2	1	1	2	1	1	1	1	1	1	1	1	2	1	1	2	1	1	1	1	2	1
1	2	1	1	1	1	2	1	1	2	1	1	1	1	1	1	1	1	2	1	1	2	1	1	1	1	2	1
1	2	2	2	2	2	2	1	1	2	2	2	2	1	1	2	2	2	2	1	1	2	2	2	2	2	2	1
1	1	1	1	1	1	2	1	1	1	1	1	3	1	1	3	1	1	1	1	1	2	1	1	1	1	1	1
0	0	0	0	0	1	2	1	1	1	1	1	3	1	1	3	1	1	1	1	1	2	1	0	0	0	0	0
0	0	0	0	0	1	2	1	1	3	3	3	5	3	3	5	3	3	3	1	1	2	1	0	0	0	0	0
0	0	0	0	0	1	2	1	1	3	1	1	1	6	6	1	1	1	3	1	1	2	1	0	0	0	0	0
1	1	1	1	1	1	2	1	1	3	1	8	8	8	8	8	8	1	3	1	1	2	1	1	1	1	1	1
7	7	7	7	7	7	2	3	3	3	1	8	8	8	8	8	8	1	3	3	3	2	7	7	7	7	7	7
1	1	1	1	1	1	2	1	1	3	1	8	8	8	8	8	8	1	3	1	1	2	1	1	1	1	1	1
0	0	0	0	0	1	2	1	1	3	1	1	1	1	1	1	1	1	3	1	1	2	1	0	0	0	0	0
0	0	0	0	0	1	2	1	1	3	3	3	3	3	3	3	3	3	3	1	1	2	1	0	0	0	0	0
0	0	0	0	0	1	2	1	1	3	1	1	1	1	1	1	1	1	3	1	1	2	1	0	0	0	0	0
1	1	1	1	1	1	2	1	1	3	1	1	1	1	1	1	1	1	3	1	1	2	1	1	1	1	1	1
1	2	2	2	2	2	2	2	2	2	2	2	2	1	1	2	2	2	2	2	2	2	2	2	2	2	2	1
1	2	1	1	1	1	2	1	1	1	1	1	2	1	1	2	1	1	1	1	1	2	1	1	1	1	2	1
1	2	1	1	1	1	2	1	1	1	1	1	2	1	1	2	1	1	1	1	1	2	1	1	1	1	2	1
1	4	2	2	1	1	2	2	2	2	2	2	5	3	3	5	2	2	2	2	2	2	1	1	2	2	4	1
1	1	1	2	1	1	2	1	1	2	1	1	1	1	1	1	1	1	2	1	1	2	1	1	2	1	1	1
1	1	1	2	1	1	2	1	1	2	1	1	1	1	1	1	1	1	2	1	1	2	1	1	2	1	1	1
1	2	2	2	2	2	2	1	1	2	2	2	2	1	1	2	2	2	2	1	1	2	2	2	2	2	2	1
1	2	1	1	1	1	1	1	1	1	1	1	2	1	1	2	1	1	1	1	1	1	1	1	1	1	2	1
1	2	1	1	1	1	1	1	1	1	1	1	2	1	1	2	1	1	1	1	1	1	1	1	1	1	2	1
1	2	2	2	2	2	2	2	2	2	2	2	2	2	2	2	2	2	2	2	2	2	2	2	2	2	2	1
1	1	1	1	1	1	1	1	1	1	1	1	1	1	1	1	1	1	1	1	1	1	1	1	1	1	1	1
0	0	0	0	0	0	0	0	0	0	0	0	0	0	0	0	0	0	0	0	0	0	0	0	0	0	0	0
0	0	0	0	0	0	0	0	0	0	0	0	0	0	0	0	0	0	0	0	0	0	0	0	0	0	0	0
