E	E	E1	E	E	E	E	E	E	E	E	E	E	E	E	E	E	E	E	E	E	E	E	E	E	E2	E	E
E	E	E	E	E	E	E	E	E	E	E	E	E	E	E	E	E	E	E	E	E	E	E	E	E	E	E	E
E	E	E	E	E	E	E	E	E	E	E	E	E	E	E	E	E	E	E	E	E	E	E	E	E	E	E	E
W	W	W	W	W	W	W	W	W	W	W	W	W	W	W	W	W	W	W	W	W	W	W	W	W	W	W	W
W	PP	P2	PP	PP	PP	PP	PP	PP	PP	PP	PP	PP	W	W	PP	PP	PP	PP	PP	PP	PP	PP	PP	PP	PP	PP	W
W	PP	W	W	W	W	PP	W	W	W	W	W	PP	W	W	PP	W	W	W	W	W	PP	W	W	W	W	PP	W
W	PG	W	W	W	W	PP	W	W	W	W	W	PP	W	W	PP	W	W	W	W	W	PP	W	W	W	W	PG	W
W	PP	W	W	W	W	PP	W	W	W	W	W	PP	W	W	PP	W	W	W	W	W	PP	W	W	W	W	PP	W
W	PP	PP	PP	PP	PP	PP	PP	PP	PP	PP	PP	PP	PP	PP	PP	PP	PP	PP	PP	PP	PP	PP	PP	PP	PP	PP	W
W	PP	W	W	W	W	PP	W	W	PP	W	W	W	W	W	W	W	W	PP	W	W	PP	W	W	W	W	PP	W
W	PP	W	W	W	W	PP	W	W	PP	W	W	W	W	W	W	W	W	PP	W	W	PP	W	W	W	W	PP	W
W	PP	PP	PP	PP	PP	PP	W	W	PP	PP	PP	PP	W	W	PP	PP	PP	PP	W	W	PP	PP	PP	PP	PP	PP	W
W	W	W	W	W	W	PP	W	W	W	W	W	P	W	W	P	W	W	W	W	W	PP	W	W	W	W	W	W
E	E	E	E	E	W	PP	W	W	W	W	W	P	W	W	P	W	W	W	W	W	PP	W	E	E	E	E	E
E	E	E	E	E	W	PP	W	W	P	P	P	PN	P	P	PN	P	P	P	W	W	PP	W	E	E	E	E	E
E	E	E	E	E	W	PP	W	W	P	W	W	W	G	G	W	W	W	P	W	W	PP	W	E	E	E	E	E
W	W	W	W	W	W	PP	W	W	P	W	H	H	H	H	H	H	W	P	W	W	PP	W	W	W	W	W	W
T	T	T	T	T	T	PP	P	P	P	W	HA	H	HB	HC	H	HD	W	P	P	P	PP	T	T	T	T	T	T
W	W	W	W	W	W	PP	W	W	P	W	H	H	H	H	H	H	W	P	W	W	PP	W	W	W	W	W	W
E	E	E	E	E	W	PP	W	W	P	W	W	W	W	W	W	W	W	P	W	W	PP	W	E	E	E	E	E
E	E	E	E	E	W	PP	W	W	P	P	P	P	P	P	P	P	P	P	W	W	PP	W	E	E	E	E	E
E	E	E	E	E	W	PP	W	W	P	W	W	W	W	W	W	W	W	P	W	W	PP	W	E	E	E	E	E
W	W	W	W	W	W	PP	W	W	P	W	W	W	W	W	W	W	W	P	W	W	PP	W	W	W	W	W	W
W	PP	PP	PP	PP	PP	PP	PP	PP	PP	PP	PP	PP	W	W	PP	PP	PP	PP	PP	PP	PP	PP	PP	PP	PP	PP	W
W	PP	W	W	W	W	PP	W	W	W	W	W	PP	W	W	PP	W	W	W	W	W	PP	W	W	W	W	PP	W
W	PP	W	W	W	W	PP	W	W	W	W	W	PP	W	W	PP	W	W	W	W	W	PP	W	W	W	W	PP	W
W	PG	PP	PP	W	W	PP	PP	PP	PP	PP	PP	PPN	P	P	PPN	PP	PP	PP	PP	PP	PP	W	W	PP	PP	PG	W
W	W	W	PP	W	W	PP	W	W	PP	W	W	W	W	W	W	W	W	PP	W	W	PP	W	W	PP	W	W	W
W	W	W	PP	W	W	PP	W	W	PP	W	W	W	W	W	W	W	W	PP	W	W	PP	W	W	PP	W	W	W
W	PP	PP	PP	PP	PP	PP	W	W	PP	PP	PP	PP	W	W	PP	PP	PP	PP	W	W	PP	PP	PP	PP	PP	PP	W
W	PP	W	W	W	W	W	W	W	W	W	W	PP	W	W	PP	W	W	W	W	W	W	W	W	W	W	PP	W
W	PP	W	W	W	W	W	W	W	W	W	W	PP	W	W	PP	W	W	W	W	W	W	W	W	W	W	PP	W
W	PP	PP	PP	PP	PP	PP	PP	PP	PP	PP	PP	PP	PP	PP	PP	PP	PP	PP	PP	PP	PP	PP	PP	P1	PP	PP	W
W	W	W	W	W	W	W	W	W	W	W	W	W	W	W	W	W	W	W	W	W	W	W	W	W	W	W	W
E	E	E	E	E	E	E	E	E	E	E	E	E	E	E	E	E	E	E	E	E	E	E	E	E	E	E	E
E3	E	E	E	E	E	E	E	E	E	E	E	E	E	E	E	E	E	E	E	E	E	E	E	E	E	E	E4